PPPPPPPPPPPPPPPPPPPP
P.1.......X.X......P
P.....X...D........P
P......X...X.......P
P..................P
PPPPPPPPPPPXXXXXXX.P
P..........#....D..P
P...X..............P
P......XPPPPPPPPPPPP
P...X..D.....X...XDP
P.....X..........XXP
PPPPPPPPPPPPPP.....P
P...XDXDX..........P
P....X.X...........P
P.............#....P
P..................P
P......PPPPPPPPPPPPP
P..Y...P.DX........P
P......P.X..X......P
PPPPPPPPPPPPPPPPPPPP