PPPPPPPPPPPPPPPPPPPP
P.0..X....X#X...#..P
P.....X............P
P......X...XPPPXPPPP
P...D............DDP
PPPP#PPP.PPXPPPPPPPP
PDXXX......XP....DDP
PX..........P.....DP
P...........PPPPPPPP
P=..X..D.....P...X?P
P.....X......P...X.P
PPPPPPPPPPPPPP.....P
PPP.#D#D#..........P
PP...X.X...........P
P.............#....P
P..................P
P......PPPPPPPPPPPPP
P..Y...P.DX........P
P......P.X..X......P
PPPPPPPPPPPPPPPPPPPP